~~~~~~~~~~~~~
~===========~
~======.====~
~======.====~
~======...==~
~===========~
~~~~~~~~~~~~~