~~~~~~~~~~~~~
~==.....====~
~==.===.====~
~==........=~
~======.====~
~======.====~
~~~~~~~~~~~~~