~~~~~~~~~~~~~
~==.......==~
~==.=====.==~
~...=====..=~
~==.=====.==~
~==.......==~
~~~~~~~~~~~~~