~~~~~~~~~~~~~
~...=...=...~
~.=.=.=.=.=.~
~.=...=...=.~
~.=========.~
~...........~
~~~~~~~~~~~~~