~~~~~~~~~~~~~
~...........~
~======.====~
~===========~
~===========~
~===========~
~~~~~~~~~~~~~