~~~~~~~~~~~~~~~~~~
~================~
~=====..=========~
~================~
~================~
~================~
~~~~~~~~~~~~~~~~~~