~~~~~~~~~~~~~
~===========~
~=====..====~
~===========~
~===========~
~===========~
~~~~~~~~~~~~~