~~~~~~~~~~~~~
~...........~
~....=======~
~.==....====~
~.=====....=~
~.========..~
~~~~~~~~~~~~~
