~~~~~~~~~~~~~
~=====.=====~
~=====.=====~
~...........~
~=====.=====~
~=====.=====~
~~~~~~~~~~~~~