~~~~~~~~~~~~~
~.....===...~
~.....=.=...~
~.....===...~
~...........~
~...........~
~~~~~~~~~~~~~