~~~~~~~~~~~~~
~===.=======~
~===....====~
~===========~
~===========~
~===========~
~~~~~~~~~~~~~