~~~~~~~~~~~~~
~===========~
~=======.===~
~===========~
~===========~
~===========~
~~~~~~~~~~~~~