~~~~~~~~~~~~~
~=====.=====~
~=====..====~
~=====.=====~
~=====.=====~
~=====.=====~
~~~~~~~~~~~~~