~~~~~~~~~~~~~
~===========~
~...........~
~===========~
~===========~
~===========~
~~~~~~~~~~~~~