~~~~~~~~~~~~~
~===========~
~======.====~
~===========~
~==.========~
~===========~
~~~~~~~~~~~~~