~~~~~~~~~~~~~
~===========~
~===....====~
~===.=======~
~===.=======~
~===========~
~~~~~~~~~~~~~