~~~~~~~~~~~~~
~===========~
~======.====~
~======.====~
~====...====~
~===========~
~~~~~~~~~~~~~